................................................................................
................................................................................
................................................................................
................................................................................
................................................................................
................................................................................
................................................................................
................................................................................
................................................................................
................................................................................
................................................................................
................................................................................
................................................................................
................................................................................
................................................................................
...................#####........................................................
...............######.###.......................................................
.............####...............................................................
...........####.................................................................
#.....#####.....##........#####.....#####.....#####.....##........#####.....##..
################################...#############################################
################################...#############################################
################################..##############################################
################################..##############################################
################################################################################
################################################################################
################################################################################
################################################################################
################################################################################
################################################################################
################################################################################
################################################################################
################################################################################
################################################################################
################################################################################
################################################################################
################################################################################
################################################################################
################################################################################
################################################################################